%%%%%%%
%     %
%  %% %
%P .  %
% %%% %
% G%. %
%%%%%%%
