%%%%%%%
%     %
% %%% %
%P%.  %
% %%% %
%  G. %
%%%%%%%
