%%%%%%%%
%P.  . %
%  % . %
%  %   %
%  % . %
% .   G%
%%%%%%%%
