%%%%%%%
% P   %
% %%% %
% %.  %
% %%% %
%  G .%
%%%%%%%
