%%%%%%%%%%%%%%%%%%%%
% .....%G  G%......%
% %%...%%  %%...%%.%
% %o.%........%. %.%
%.%%.%.%%%%%%.%.%%.%
%..... ..P.....   o%
%%%%%%%%%%%%%%%%%%%%
