%%%%%%%
%.P   %
% %%% %
% %.  %
% %%% %
%  G .%
%%%%%%%
