%%%%%%%
%    .%
% %%% %
%P%.  %
% %%% %
%  G  %
%%%%%%%
